111111
10011
120011
1100N1
111111