111111
100101
12R011
1100N1
111111