111111
100101
020011 
1100N1
111111