111111
100101
120011
1100N1
110111