R      800      600   

NO           ./xpm/wood.xpm

WE       ./xpm/stone.xpm

SO                                               ./xpm/metal.xpm

EA  ./xpm/brick.xpm

S    ./xpm/eye.xpm

F   119, 128, 123     

C   48, 16, 243     


 11111111111
10N011
1111111