R            1000                 800




NO       ./xpm/wood.xpm


SO              ./xpm/wood.xpm


   WE      ./xpm/wood.xpm


                            EA  ./xpm/wood.xpm

S    ./xpm/eye.xpm


F  119,   128,          123


C           48          ,  169       ,          243










                     
      

11111111111111111111111111
1S013141516100000000000011
1000000000000000000000011
12500000000000000000001111
13100000000000000000000011
16300000000000000000000011
11111111111111111111111111